111111
1000P1
1000E1
1000C1
111111
