111111
100001
111111



111111
