111111
1EC0P1
100101
100101
111111
