111111111111111
111111111111111
100000000001111
111111111111111
