111111111111111
111111111111111
111111111111111
111111111111111
111111111111111
111111111111111
111111111111111
100000000000001
1111111P1111111
1111E1111111111
1111C1111111111
111111111111111
111111111111111
111111111111111
111111111111111
111111111111111
111111111111111
111111111111111
111111111111111
111111111111111
111111111111111
111111111111111
111111111111111
