111111111111111
111111111111111
1000000100000C1
1000001P1000001
1000E0010000001
1000C0000000001
111111111111111
111111011111111
111111111111111
