11111111111111111111111111111111111111111111111111111111111111111111111111111111111111111
10000000000C0000000000C0000000000C0000000000C0000100000C0000000000C0000000000C00000000001
10000010000000000000000000000000000000000000000000000000000000000000000000000000000000001
1P0000E1000111111111111111111111111111111111111111000000000000000000000000000000000000001
10000010000C0000000000C0000000000C0000000000C0000100000C0000000000C0000000000C00000000001
10000000011111111111111111100000000000000000000001000000000000000000000000000000000000001
10000000000000000000000000000000000000000000000000000000000000000000000000000000000000001
10000010000C0000000000C0000000000C0000000000C0000100000C0000000000C0000000000C00000000001
10000000011111111111111111100000000000000000000001000000000000000000000000000000000000001
10000000000000000000000000000000000000000000000000000000000000000000000000000000000000001
10000010000C0000000000C0000000000C0000000000C0000100000C0000000000C0000000000C00000000001
10000000011111111111111111100000000000000000000001000000000000000000000000000000000000001
10000000000000000000000000000000000000000000000000000000000000000000000000000000000000001
10000010000C0000000000C0000000000C0000000000C0000100000C0000000000C0000000000C00000000001
10000000011111111111111111100000000000000000000001000000000000000000000000000000000000001
10000000000000000000000000000000000000000000000000000000000000000000000000000000000000001
10000010000C0000000000C0000000000C0000000000C0000100000C0000000000C0000000000C00000000001
10000000011111111111111111100000000000000000000001000000000000000000000000000000000000001
10000000000000000000000000000000000000000000000000000000000000000000000000000000000000001
1C000001000111111111111111111111111111111111111111000000000000000000000000000000000000001
10000010000C0000000000C0000000000C0000000000C0000100000C0000000000C0000000000C00000000001
10000000011111111111111111100000000000000000000001000000000000000000000000000000000000001
1C000001000111111111111111111111111111111111111111000000000000000000000000000000000000001
10000010000C0000000000C0000000000C0000000000C0000100000C0000000000C0000000000C00000000001
10000000011111111111111111100000000000000000000001000000000000000000000000000000000000001
1C000001000111111111111111111111111111111111111111000000000000000000000000000000000000001
10000010000C0000000000C0000000000C0000000000C0000100000C0000000000C0000000000C00000000001
10000000011111111111111111100000000000000000000001000000000000000000000000000000000000001
11111111111111111111111111111111111111111111111111111111111111111111111111111111111111111
