1111111111111
10010C0E00E01
100C011111001
1P0C110000001
1111111111111
