1111111111111
1001000000001
1000011111001
100P1100C0001
1111111111111
