1111011111111
10010C0000E01
100C011111001
1P0C110000001
1111111111111
