1111111111111
1cc1ccccEccc1
1cccc11111cc1
1ccP11ccCccc1
1111111111111
