1111111111111
1001000000E01
1000011111001
10001100C0001
1111111111111
