1111111111111
1CCCCCCCCC
1CCCECCCCCCC1
1CCPCCCCCCCC1
1111111111111
