1111111111111

1CCCCCCCCCCC1
1CCCECCCCCCC1
1CCPCCCCCCCC1
1111111111111
