1111111111111111111111111111
100000111110000CCCCC1111C001
10000011100CCCC0000CCC111001
1000000000000110000000000001
10000P0000001EC0000000000001
100000000CCCC1CCCCC000000001
1000000111111111000000000001
1111111111111111111111111111
